

SO ./textures/wall_doom_1.xpm



R 1920 1080
NO ./textures/wall_doom_2.xpm
WE ./textures/wall_doom_3.xpm
EA ./textures/wall_doom_5.xpm

S ./textures/sprite-1.xpm



C 60, 48, 230
F 255, 0, 213

        1111111111111111111111111
        1000000000110000000000001
        1011000001110000000000001
        1001000000000000000000001
111111111011000001110000200000001
100000000011000001010111000011111
11110111111111011100000010001
11110111111111011101010010001
11000000110101011100000110001
10000000000000011000000010201
10000000000000001101010001001
1100000111010101111101111000111
11110111 1110101 101111010N01
11111111 1111111 111111111111
