

SO ./textures/wall_doom_1.xpm



R 1920 1080
NO ./textures/wall_doom_2.xpm
WE ./textures/wall_doom_3.xpm
EA ./textures/wall_doom_5.xpm

S ./textures/sprite-1.xpm



C ./textures/ceil_doom_1.xpm
F ./textures/ground_doom_1.xpm
L 255,1,30

        1111111111111111111111111
        1000000000110000000000001
        1L11000001110000000L00001
        1001000000L00000000000001
111111111011000001110000200000001
1000000L0011000001010111000011111
1111L111111111L11100000010001
11110111111111011101010010L01
11000000110101011100L00110001
10000000000000011000000010201
10000L0000000L001101010001001
1100000111010101111101111000111
11110111 1110101 101111010N01
11111111 1111111 111111111111
