
C 0,255,240
SO ./textures/wall_doom_1.xpm
R 1920 1080
NO ./textures/wall_doom_2.xpm
WE ./textures/wall_doom_3.xpm
EA ./textures/wall_doom_5.xpm
S ./textures/sprite-1.xpm
F 211,   205,  200
L 255, 255, 255

        1111111111111111111111111
        100L000000110000000000001
        1011000001110000000000001
        100100L000L0000000L000001
111111111011000001110000200000001
1L0000000L11000001010111000011111
1111L111111111011100000010L01
11110111111111011101010010001
11000000110101L11100000110001
10000000000000011000000010201
1000L0000000L0001101010001L01
1100000111010101111101111010111
11110111 1110101 101111010N01
11111111 1111111 111111111111
