
C 0,0,0



SO ./textures/s5.xpm


		R 		300 300
NO ./textures/s5.xpm






WE ./textures/s5.xpm


EA ./textures/s5.xpm

S ./textures/s3.xpm
F 211,205,210

        1111111111111111111111111
        1000000000110000000000001
        1011000001110002222222201
        1001000000000000000000001
111111111011000001110000000000001
100000000011000001110111100011111
11110111111111011100000010001
11110111111111011101010010001
11000000110101011100000111001
10000000000000011000000010201
10000000000000001101010010001
11000001110101011111011110N0111
11110111 1110101 101111010001
11111111 1111111 111111111111
