
C 116,193,232



SO ./textures/1.png


R 200 200
NO ./textures/1.png






WE ./textures/1.png


EA ./textures/1.png

S ./textures/1.png
F 211,205,210
        1111111111111111111111111
        1000000000110000000000000
        1011000001110000000000001
        1001000000000000000000001
111111111011000001110000000000001
100000000011000001110111110111111
11110111111111011100000010001
11110111111111011101010010001
11000000110101011100000111201
10002000000000011000000010001
10000000000000001101010010001
1100000111010101111101111000111
11110111 1110101 101111010E01
11111111 1111111 111111111111
