
C 0,0,0
SO ./textures/wall_doom_1.xpm
R 192 108
NO ./textures/wall_doom_2.xpm
WE ./textures/wall_doom_3.xpm
EA ./textures/wall_doom_5.xpm
S ./textures/sprite-1.xpm
F 211  ,   205   ,200

        1111111111111111111111111
        1000000000110000000000001
        1211000001110000000000001
        1201000000000000000000001
111111111211000001110000000000001
100000000211000001010111000011111
11110111111111011100000010001
11110111111111011101010010001
11000000110101011100000111001
10000000000000011000000010001
10000000000000001101010001001
11000001110101011111011110N0111
11110111 1110101 101111010001
11111111 1111111 111111111111
