
C 225,30,0



SO ./path_to_the_south_texture


R 1920 1080
NO ./path_to_the_north_texture






WE ./path_to_the_west_texture


EA ./path_to_the_east_texture

S ./path_to_the_sprite_texture
F 220,100,0







            1111111111111111111111111
      11111 1000000000110000000000001
      10001 1011000001110000002000001
      10001 1001000000000000200000001
    111101111011000001110000000000001
    100000000011000001111111110111111
    11110111111111011100000010001
    11110111111111011101010010001
    11000000110101011100000010001
    10002000000000001100000000001
    100000000000000011010100100011
    1100000111010101111101111S011
    11110111 10100010000111010001
    01111111 11110110111111111111
                100111001
          111110100000001
                100010101
                111111111
