
C 116,193,232



SO ./textures/1.png


R 1000 1000
NO ./textures/1.png






WE ./textures/1.png


EA ./textures/1.png

S ./textures/1.png
F 211,205,210
        1111111111111111111111111
        1000000000110000000000001
        1011000001110000002000001
        1001000000000000000000001
111111111011000001110000000000001
100000000011000001110111100011111
11110111111111011100000010001
11110111111111011101010010001
11000000110101011100000111001
1000200000000001100000010001
10000000000000001101010010001
11000001110101011111011110N0111
11110111 1110101 101111010001
11111111 1111111 111111111111
