
C 116,193,232



SO ./textures/1.png


R 400 400
NO ./textures/1.png






WE ./textures/1.png


EA ./textures/1.png

S ./textures/1.png
F 211,205,210


11111
10001
10001
10001
10001
10001
10N01
10001
11111
